2222222999999992229999999
.......82222227...4999999
1115..............4999999
9927........65....4999999
93..........87....8999999
93.................499999
995................899999
993.................82999
993......65...........899
993.....69915..........49
993....6999995.........49
993...699999995........89
993...4999999995........4
993...8999999993........4
993....822229927........4
993.........43..........4
993.........43..........4
993.........43..........4
993.........43..........4
99915.......43..........4
999995....619915........4
99999911119999995.......4
9999999999999999915.....4
9999999999999999999115..4
9999999999999999999999119